###############################
##########           ##########
########               ########
#######                 #######
#####                     #####
####                       ####
####                       ####
###'                        ###
##  '          # #           ##
##   '         # #           ##
#     '        # #            #
#      '       # #            #
#       ################      #
#       #      ###            #
#       #      ###            #
#       #                     #
#       #       S             #
#       #                     #
#                      #      #
#                      #      #
#                      #      #
##         ##          #     ##
##                           ##
###                         ###
####                       ####
####                       ####
#####                     #####
#######                 #######
########               ########
##########           ##########
###############################
