#####################
######         ######
#####           #####
###               ###
###               ###
##                 ##
#                   #
#                   #
#                   #
#                   #
#                   #
#                   #
#                   #
#                   #
#                   #
##                 ##
###               ###
###               ###
#####           #####
######         ######
#####################
