###############################
##########           ##########
########               ########
#######                 #######
#####                     #####
####          ###          ####
####       #########       ####
###   ##               ##   ###
##     ##    #####    ##     ##
##      ##   #####   ##      ##
#   #    ##  #####  ##    #   #
#   ##                   ##   #
#   ##      #######      ##   #
#   ###    ##     ##    ###   #
#   #####             #####   #
#   ######           ######   #
#   #####             #####   #
#   ###    ##     ##    ###   #
#   ##      #######      ##   #
#   ##                   ##   #
#   #    ##  #####  ##    #   #
##      ##   #####   ##      ##
##     ##    #####    ##     ##
###   ##               ##   ###
####       #########       ####
####          ###          ####
#####                     #####
#######                 #######
########               ########
##########           ##########
###############################
