###############################
##########           ##########
########               ########
#######                 #######
#####                     #####
####                       ####
####                       ####
###                         ###
##                           ##
##                           ##
#                             #
#                             #
#                             #
#                             #
#                             #
#                             #
#                             #
#                             #
#                             #
#                             #
#                             #
##                           ##
##                           ##
###                         ###
####                       ####
####                       ####
#####                     #####
#######                 #######
########               ########
##########           ##########
###############################
