###############################
##########           ##########
########               ########
#######                 #######
#####                     #####
####                       ####
####                       ####
###                         ###
##             ###           ##
##             ###           ##
#              ###            #
#              ###            #
#       ################      #
#              ###            #
#              ###            #
#              ###            #
#                             #
#                             #
#                             #
#                             #
#                             #
##                           ##
##                           ##
###                         ###
####                       ####
####                       ####
#####                     #####
#######                 #######
########               ########
##########           ##########
###############################
