###############################
##########           ##########
########               ########
#######                 #######
#####         #           #####
####          #            ####
####          #            ####
###                         ###
##                           ##
##            #              ##
#                             #
#             #               #
#                             #
#             #               #
#                             #
#  ###  # # #   # # #  ###    #
#                             #
#             #               #
#                             #
#             #               #
#                             #
##            #              ##
##                           ##
###                         ###
####          #            ####
####          #            ####
#####         #           #####
#######                 #######
########               ########
##########           ##########
###############################
