###############################
##########           ##########
########     #####     ########
#######     #     #     #######
#####                     #####
####          ###          ####
####       #########       ####
###   ##               ##   ###
##     ##    #####    ##     ##
##      ##   #####   ##      ##
#   #    ##  #####  ##    #   #
#   #                     #   #
#   #       #######       #   #
#   #      #       #      #   #
#   #####             #####   #
#   #####             #####   #
#   #####             #####   #
#   #      #       #      #   #
#   #       #######       #   #
#   #                     #   #
#   #    ##  #####  ##    #   #
##      ##   #####   ##      ##
##     ##    #####    ##     ##
###   ##               ##   ###
####       #########       ####
####          ###          ####
#####                     #####
#######     #     #     #######
########     #####     ########
##########           ##########
###############################
