###############################
##########           ##########
########     #####     ########
#######     #     #     #######
#####                     #####
####          ###          ####
####       #########       ####
###                         ###
##                           ##
##                           ##
#   #        #####        #   #
#   #                     #   #
#   #       #######       #   #
#   #      #       #      #   #
#   #                     #   #
#   ###                 ###   #
#   #                     #   #
#   #      #       #      #   #
#   #       #######       #   #
#   #                     #   #
#   #        #####        #   #
##                           ##
##                           ##
###                         ###
####       #########       ####
####          ###          ####
#####                     #####
#######     #     #     #######
########     #####     ########
##########           ##########
###############################
