###############################
##########           ##########
########    #######    ########
#######     #     #     #######
#####                     #####
####          ###          ####
####       #########       ####
###   ##               ##   ###
##     ##    #####    ##     ##
##      ##   #####   ##      ##
#   #    ##  #####  ##    #   #
#   ##                   ##   #
#   ##     #########     ##   #
#   ###    #       #    ###   #
#   #####             #####   #
#   ######           ######   #
#   #####             #####   #
#   ###    #       #    ###   #
#   ##     #########     ##   #
#   ##                   ##   #
#   #    ##  #####  ##    #   #
##      ##   #####   ##      ##
##     ##    #####    ##     ##
###   ##               ##   ###
####       #########       ####
####          ###          ####
#####                     #####
#######     #     #     #######
########    #######    ########
##########           ##########
###############################
