###############################
##########           ##########
########               ########
#######                 #######
#####                     #####
####          #            ####
####          #            ####
###           #             ###
##            #              ##
##            #              ##
#     #       #        #      #
#             #               #
#             #               #
#             #               #
#                             #
#    ########   #########     #
#                             #
#             #               #
#             #               #
#             #               #
#     #       #        #      #
##            #              ##
##            #              ##
###           #             ###
####          #            ####
####          #            ####
#####                     #####
#######                 #######
########               ########
##########           ##########
###############################
