######################
######          ######
###     ######     ###
###   ##########   ###
###                ###
##    ##       ##   ##
#    ####     ####   #
#       ##   ##      #
#                    #
#                    #
#                    #
#       ##   ##      #
#    ####     ####   #
#     ##       ##    #
#                    #
##                  ##
###   ##########   ###
###     ######     ###
#####            #####
######          ######
######################
