#####################
######         ######
###     #####     ###
###   #########   ###
###               ###
##    ##      ##   ##
#    ####    ####   #
##      ##  ##     ##
##                 ##
##                 ##
##                 ##
##      ##  ##     ##
#    ####    ####   #
#     ##      ##    #
#                   #
##                 ##
###   #########   ###
###     #####     ###
#####           #####
######         ######
#####################
